1111111111111111111111111111111111111111111111111111111111
1P00000000000000000C0000000000000000000C000000000000000001
1111111111111111111111111111111111111111111111111111111101
100000000000C00000000000000000C000000000000000000000000101
1C11111111111111111111111111111111111111111111111111110101
101000C00000000000000000000000C00000000000000000000C010101
1C10111111111111111111111111111111111111111111111111010101
101C1E000000C000000000C000000000000C0000000000000000010101
1C10111111111111111111111111111111111111111111111111110101
101C0000000000C0000000000C000000000000000000000C0000000101
1011111111111111111111111111111111111111111111111111111101
1C0000000000000000000000000C00000000000000000000000000C001
1111111111111111111111111111111111111111111111111111111111