11111111111111111111111111111111111111111
1P100001C100000000000000000000010F0000111
1000000000000000000000F000000000000000E01
1000000010000000001C100000000001000000111
11111111111111111111111111111111111111111