1111111111111
1P00FC000E001
1111111111111
