1111111111111
1P000C000E001
1111111111111
