11111111111111111111111111111111111111111111111111111111111111111
1111111P000000000000000000000000000000000000000000000000000111111
11111111111111111111111111111111011111111111111111111111110111111
11111111111111111111111111111111011111111111111111111111110111111
11111111111111111111111111111111011111111111111111111111110111111
10000000C0000000000000000000000000000000000000C111111111110111111
10111111011111111111111111111111111111111111111111111111110111111
1011111101100000000000C11111111111111C111111111111111111110111111
10111111011011111111111111111111111110111111111111111111110111111
10111111011011111111111100000000000000000000000C11111111110111111
10111111011011111111111101111111111110111111111111111111110111111
10111111011000000000000001111111111110100000001111111111110111111
1011111101111111111111111111111111111010C000000000000000000111111
10111111000000000000000000000000000000100000001111111111111111111
10111111011111111111111111111111111111111111111111111111111111111
1000000000000000000000000000000000000000000000000000000E111111111
11111111111111111111111111111111111111111111111111111111111111111